1111111111111
1P100000000C1
1010111111111
10001C1101E01
1000100001001
1000100101001
1000100101001
1000000100001
100000C110001
1000000100001
1000000100001
10000001000C1
1000000100001
1000000100001
10C0000000001
1000000100001
111111110C001
1C1000010C001
101010000C001
101010010C001
101010010C001
101010010C001
101010010C001
100010C10C001
1111111111111