1111111111111
1P100000000C1
1010111111111
1000101101EC1
1000100001101
1000100101001
10001001010C1
1000000100001
1000000110001
10C0000100001
1000000100101
10000001001C1
1111110100111
1C10000100001
1010100001101
100010010C101
1111111111101
1C10000100001
1010100000001
101010010C001
1010100100001
1010100100001
1010110110111
100010C1100C1
1111111111111