11111111
1P000001
10111001
101C1001
10101001
100000E1
11111111