111111111111
1P1000000001
101010011111
10001C0100E1
111111111111