1111111111111
1P100000000C1
1010111111011
10001C1101001
10E0100001101
1000100101001
1000100101001
1000000100001
100000C110001
1000000000001
1000000100101
10000001000C1
1000000100111
1000000100001
10C0000000001
1000000100001
101110010C001
1C1000010C001
101010000C001
101010010C001
101010010C001
101010010C001
101010010C001
100010C10C001
1111111111111w