111111111111
1P1000000001
101011111111
10001C1101E1
100010000101
100010010101
100010010101
100000010001
111111111111