111111111111
1P1000000001
101010011101
10001C0101E1
111111111111