111111111111
1P0000000001
100000000001
10000C0000E1
111111111111